Dato,Type,Beløp,Kategori,Saldo
2025-09-01,Inntekt,10000,Lønn,10000
2025-09-03,Utgift,2500,Husleie,7500
2025-09-05,Utgift,800,Mat,6700
2025-09-08,Utgift,300,Fritid,6400
2025-09-10,Inntekt,500,Stipend,6900
2025-09-11,Utgift,600,Transport,6300
